{
  "Identity": "Rooms",
  "Name": "many rooms",
  "Procedural": true,
  "Template": "
222222222222222222222222222222222222222222222222
222222222222222222222222222222222222222222222222
222200000000000222222222222222222200000000000222
222200000000000222222222222222222200000000000222
222200000000000222222222222222222200000000000222
222200000000000222222222222222222200000000000222
222200000000000222222222222222222200000000000222
222200000000000222222222222222222200000000000222
222222222222222222222222222222222222222222222222
222222222222222222222222222222222222222222222222
222222222222222220000000000022222222222222222222
222222222222222220000300000022222222222222222222
222222222222222220000000000022222222222222222222
222222222222222220000000000022222222222222222222
222222222222222220000000000022222222222222222222
222222222222222222222222222222200000000000222222
222222000000000002222222222222200000000000222222
222222000000000002222222222222200000000000222222
222222000000000002222222222222200000000000222222
222222000000000002222222222222222222222222222222
222222000000000002222222222222222222222222222222
222222000000000002222222222222222222222222222222
222222222222222222222222222222222222222222222222
222222222222222222222222222222222222222222222222
222222222222222222222222222222222222222222222222
222222222222222222200000000000022222222222222222
222222222222222222200000000000022222222222222222
222222222222222222200000000000022222222222222222
222222222222222222222222222222222222222222222222"
}
