{
  "Identity": "Capital",
  "Name": "База 21",
  "Template": "
#########################.############
#########################.############
#.................#...............####
#.....#######.....#.......#.#.....####
#.....###>###.....#.....###.###...####
#.....#.....#.....#...#####.#####.####
#.....##...##.....#.#####.....########
#.....###.###.....#.###.........######
#......##.##......#...................
#.................#.###.........######
#########.#########.#####.....########
#########.#########...#####.#####.####
#.......................###.###...####
#.........................#.#.....####
#######...#####...#######.........####
#######...#####...#######.........####
#.....#.....#.....#.....#.........####
#.................#...............####
###############.######################
#..........###...........##......#####
#######....###....#########......#####
#........................##......#####
######################################"
}